1111111111111
1P000C000E0K1
1111111111111