1111111111111
1P0K0C00000E1
1111111111111