1111111111111
10010000000C1
1000011111001
1P001K1E00001
1111111111111