1111111111111111111111111111111111
1E000K000000000C00000C000000000001
101001010010000010100100K000010101
1010010010101010001001000K00010101
1P0000000C00C0000K00000000000000C1
1111111111111111111111111111111111