11111111111111111111
111000C0000000001001
111000KK000000001111
100000000000000K0001
100C000000P000000001
10000000000000111111
11000000000001000001
11100000KK0001100001
1E000000000KC0111111
11111111111111111111