NO ./textures/xpm/north.xpm
SO ./textures/xpm/south.xpm
WE ./textures/xpm/west.xpm
EA ./textures/xpm/east.xpm

F 220,100,0
C 225,30,255

                  111111111    11111111 11111111
                 100000001     1000001  10000001
                100000001      100001   10000001
               100000001       10001    10000001
              100000001        1001     10000001
             100000001         101      10000001
            100000001          11       10000001
           100000001           1        10000001
          100000001                     10000001
         100000001                     10000001
        100000001                     10000001
       100000001                     10000001
      100000001                     10000001
     100000001                     10000001
    100000001                     10000001
   100000001                     10000001
  100000001                     10000001
  1000000011111111111111111    100000001
  1000000000000000000000001    100000001       1
  1000000000000000000000001    100000001      11
  1000000000000000000000001    100000001     101
  1000000000000000000000001    100000001    1001
  1000000000000000000000001    100000001   10001
  1111111111111111110000001    100000001  100001
                   10000001    100000001 1000001
                   10000001     1111111  1111111
                   10000001
                   10000001
                   10000001
                   10000001
                   10000001
                   11111111
