NO ./textures/xpm/north.xpm
SO ./textures/xpm/south.xpm
WE ./textures/xpm/west.xpm
EA ./textures/xpm/east.xpm

F 220,100,0
C 225,30,255

                                                         11111111111
                                                         10000000001
                                                         10110000001
                                                         10010000001
11111111111111111111111111111111111111111111111111111111110000000001
10000000001100000111011100000000000000000000000000000000000000000001
11110111111111011100000010001111111111111111111111111111111111111111
11110111111111011101010010001
11000000110101011100000010001
10000000000000001100000010001
10000000000000001101010010001
11000001110101011111011110N0111
11110111 1110101 101111010001
11111111 1111111 111111111111